1111111111111111111111
1E0000000000000C000001
1010010100100000010101
1010010010101010010101
1P0000000C00C000000001
10000000C0000000000001
1001000000011111000001
1111111111111111111111
